{
	"9j4s": {"A": "I", "B": "G"},
	"9qwj": {"A": "T", "B": "U"},
	"9hlj": {"A": "D", "B": "E"},
	"9o62": {"A": "b", "B": "a"},
	"9ru5": {"A": "A", "B": "B"},
	"9qwk": {"A": "D", "B": "E"},
	"9j4t": {"A": "D", "B": "E"},
	"9rxm": {"A": "A", "B": "B"},
	"9j4u": {"A": "D", "B": "E"}
}