{
	"8jbv": {"A": "m", "B": "n"},
	"8rlt": {"A": "D", "B": "E"},
	"8sgb": {"A": "C", "B": "D"},
	"8u0y": {"A": "C", "B": "D"},
	"8vz9": {"A": "C", "B": "D"},
	"8wul": {"A": "G", "B": "H"},
	"9aud": {"A": "A", "B": "B"},
	"8f5a": {"A": "C", "B": "D"},
	"8qfy": {"A": "III", "B": "JJJ"},
	"8ryo": {"A": "D", "B": "E"},
	"8ryp": {"A": "D", "B": "E"},
	"8vcx": {"A": "D", "B": "E"},
	"8vq8": {"A": "A", "B": "B"},
	"9btx": {"A": "G", "B": "H"},
	"8rj5": {"A": "I", "B": "J"},
	"8vz8": {"A": "C", "B": "D"},
	"8yiv": {"A": "D", "B": "E"},
	"8en8": {"A": "D", "B": "E"},
	"8ryq": {"A": "I", "B": "J"},
	"8tfn": {"A": "A", "B": "B"},
	"8trq": {"A": "D", "B": "E"},
	"8zo4": {"A": "A", "B": "B"},
	"8rym": {"A": "D", "B": "E"},
	"8t4z": {"A": "C", "B": "D"},
	"8trr": {"A": "D", "B": "E"},
	"8v4z": {"A": "N", "B": "O"},
	"8wte": {"A": "A", "B": "B"},
	"8zox": {"A": "D", "B": "E"},
	"8pjg": {"A": "D", "B": "E"},
	"8trl": {"A": "G", "B": "H"},
	"8vd0": {"A": "I", "B": "J"},
	"8ye4": {"A": "I", "B": "J"},
	"8ro5": {"A": "A", "B": "B"},
	"8rvd": {"A": "L", "B": "K"},
	"9c3e": {"A": "A", "B": "B"},
	"7q9a": {"A": "D", "B": "E"},
	"7q9b": {"A": "DDD", "B": "EEE"},
	"7zt7": {"A": "D", "B": "E"},
	"8dfw": {"A": "D", "B": "G"},
	"8dnt": {"A": "M", "B": "P"},
	"8es8": {"A": "A", "B": "B"},
	"8es9": {"A": "A", "B": "B"},
	"8gon": {"A": "D", "B": "E"},
	"8i5c": {"A": "D", "B": "E"},
	"8i5d": {"A": "A", "B": "B"},
	"8shi": {"A": "I", "B": "J"},
	"9ejg": {"A": "D", "B": "E"},
	"9gv6": {"A": "D", "B": "E"},
	"9gv7": {"A": "D", "B": "E"},
	"9hi7": {"A": "D", "B": "E"},
	"8zd4": {"A": "D", "B": "G"}
}